##########################################################################################################################################################################
#                                                                                                                                                                        #
#  ##############################################################################################################################   #   #   #   #   #   #    #   #   ### #
#                                                                                                                               #   #   #   #   #   #   #    #   #   # # #
#                                                                                                                               #   #   #   #   #   #   #    #   #   # # #
#                                                                                                                               #   #   #   #   #   #   #    #   #   # # #
#  ##################################################################################################################################   #   #   #   #   #    #   #   # # #
#                                                                                                                                   #   #   #   #   #   #    #   #   # # #
#                                                                                                                                   #   #   #   #   #   #    #   #   # # #
#                                                                                                                                   #   #   #   #   #   #    #   #   # # #
#  ######################################################################################################################################   #   #   #   #    #   #   # # #
#                                                                                                                                       #   #   #   #   #    #   #   # # #
#                                                                                                                                       #   #   #   #   #    #   #   # # #
#                                                                                                                                       #   #   #   #   #    #   #   # # #
#  ##########################################################################################################################################   #   #   #    #   #   # # #
#                                                                                                                                           #   #   #   #    #   #   # # #
#                                                                                                                                           #   #   #   #    #   #   # # #
#                                                                                                                                           #   #   #   #    #   #   # # #
#  ##############################################################################################################################################   #   #    #   #   # # #
#                                                                                                                                               #   #   #    #   #   # # #
#                                                                                                                                               #   #   #    #   #   # # #
#                                                                                                                                               #   #   #    #   #   # # #
# ###################################################################################################################################################   #    #   #   # # #
#                                                                                                                                                   #   #    #   #   # # #
#                                                                                                                                                   #   #    #   #   # # #
#                                                                                                                                                   #   #    #   #   # # #
#  ######################################################################################################################################################    #   #   # # #
#                                                                                                                                                       #    #   #   # # #
#                                                                                                                                                       #    #   #   # # #
#                                                                                                                                                       #    #   #   # # #
#  ###########################################################################################################################################################   #   # # #
#                                                                                                                                                            #   #   # # #
#                                                                                                                                                            #   #   # # #
#                                                                                                                                                            #   #   # # #
#  ###############################################################################################################################################################   ### #
#                                                                                                                                                                #   # # #
#                                                                                                                                                                #   # # #
#                                                                                                                                                                #   # # #
#  ##################################################################################################################################################################### #
#                                                                                                                                                                      # #
#                                                                                                                                                                      # #
#                                                                                                                                                                      # #
#  ##################################################################################################################################################################### #
#                                                                                                                                                                      # #
#                                                                                                                                                                      # #
#S                                                                                                                                                                     #E#
##########################################################################################################################################################################