###################################################################
#                                                                 #
#                                                                 #
#                                                                 #
#                       #################                         #
#                       #                                         #
#                       #                     #                   #
#                       #                     #                   #
#                       #                     #                   #
#                       #                              #          #
#                       #      ####################    #          #
#                       #                              #          #
#                       #           E                  #          #
#                       ################################          #
#                                                                 #
#                                                                 #
#                                                                 #
#     S                                                           #
#                                                                 #
###################################################################
