xxxxxxxxxxxxxxxxxxxxxxxxxxxxxxxxxxxxxxxxxxxxxxxxxxxxxxxxxxxxxxxxxxx
x                                                                 x
x                                                                 x
x                                                                 x
x                       xxxxxxxxxxxxxxxxx                         x
x                       x                                         x
x                       x                     x                   x
x                       x                     x                   x
x                       x                     x                   x
x                       x                              x          x
x                       x      xxxxxxxxxxxxxxxxxxxx    x          x
x                       x                              x          x
x                       x           E                  x          x
x                       xxxxxxxxxxxxxxxxxxxxxxxxxxxxxxxx          x
x                                                                 x
x                                                                 x
x                                                                 x
x     S                                                           x
x                                                                 x
xxxxxxxxxxxxxxxxxxxxxxxxxxxxxxxxxxxxxxxxxxxxxxxxxxxxxxxxxxxxxxxxxxx