XXXXXXXXXXXXXXXXXXXXXXXXXXXXXXXXXXXXXXXXXXXXXXXXXXXXXXXXXXXXXXXXXXXXXXXXXXXXXXXXXXXXXXXXXXXXXXXXXXXXXXXXXX
X                                                                                                        X
X  XXXXXXXXXXXXXXXXXXXXXXXXXXXXXXXXXXXXXXXXXXXXXXXXXXXXXXXXXXXXXXXXXXXXXX   X   X   X   X   X   X    X   X
X                                                                       X   X   X   X   X   X   X    X   X
X                                                                       X   X   X   X   X   X   X    X   X
X                                                                       X   X   X   X   X   X   X    X   X
X  XXXXXXXXXXXXXXXXXXXXXXXXXXXXXXXXXXXXXXXXXXXXXXXXXXXXXXXXXXXXXXXXXXXXXXXXXX   X   X   X   X   X    X   X
X                                                                           X   X   X   X   X   X    X   X
X                                                                           X   X   X   X   X   X    X   X
X                                                                           X   X   X   X   X   X    X   X
X  XXXXXXXXXXXXXXXXXXXXXXXXXXXXXXXXXXXXXXXXXXXXXXXXXXXXXXXXXXXXXXXXXXXXXXXXXXXXXX   X   X   X   X    X   X
X                                                                               X   X   X   X   X    X   X
X                                                                               X   X   X   X   X    X   X
X                                                                               X   X   X   X   X    X   X
X  XXXXXXXXXXXXXXXXXXXXXXXXXXXXXXXXXXXXXXXXXXXXXXXXXXXXXXXXXXXXXXXXXXXXXXXXXXXXXXXXXX   X   X   X    X   X
X                                                                                   X   X   X   X    X   X
X                                                                                   X   X   X   X    X   X
X                                                                                   X   X   X   X    X   X
X  XXXXXXXXXXXXXXXXXXXXXXXXXXXXXXXXXXXXXXXXXXXXXXXXXXXXXXXXXXXXXXXXXXXXXXXXXXXXXXXXXXXXXX   X   X    X   X
X                                                                                       X   X   X    X   X
X                                                                                       X   X   X    X   X
X                                                                                       X   X   X    X   X
X  XXXXXXXXXXXXXXXXXXXXXXXXXXXXXXXXXXXXXXXXXXXXXXXXXXXXXXXXXXXXXXXXXXXXXXXXXXXXXXXXXXXXXXXXXX   X    X   X
X                                                                                           X   X    X   X
X                                                                                           X   X    X   X
X                                                                                           X   X    X   X
X  XXXXXXXXXXXXXXXXXXXXXXXXXXXXXXXXXXXXXXXXXXXXXXXXXXXXXXXXXXXXXXXXXXXXXXXXXXXXXXXXXXXXXXXXXXXXXX    X   X
X                                                                                               X    X   X
X                                                                                               X    X   X
X                                                                                               X    X   X
X  XXXXXXXXXXXXXXXXXXXXXXXXXXXXXXXXXXXXXXXXXXXXXXXXXXXXXXXXXXXXXXXXXXXXXXXXXXXXXXXXXXXXXXXXXXXXXXXXXXX   X
X                                                                                                    X   X
X                                                                                                    X   X
X  S                                                                                                 X E X
XXXXXXXXXXXXXXXXXXXXXXXXXXXXXXXXXXXXXXXXXXXXXXXXXXXXXXXXXXXXXXXXXXXXXXXXXXXXXXXXXXXXXXXXXXXXXXXXXXXXXXXXXX

