XXXXXXXXXXXXXXXXXXXXXXXXXXXXXXXXXXXXXXXXXXXXXXXXXXXXXXXXXXXXXXXXXXX
X                                                                 X
X                                                                 X
X                                                                 X
X                                       X                         X
X                                       X                         X
X                                       X                         X
X                                       X                         X
X                                       XXXXXXXXXXXXX             X
X                                       X                         X
X                                       X                         X
X             S                         X   E                     X
X                                       X                         X
X                                       X                         X
X                                       X                         X  
X                                       X                         X
X                                       X                         X
X                                       X                         X
X                                       X                         X
X                                       X                         X
X                                                                 X
X                                                                 X
X                                                                 X
X                                                                 X
X                                                                 X
XXXXXXXXXXXXXXXXXXXXXXXXXXXXXXXXXXXXXXXXXXXXXXXXXXXXXXXXXXXXXXXXXXX