###################################################################
#                                                                 #
#                                                                 #
#                                                                 #
#                                                                 #
#                                                                 #
#                                                                 #
#                                                                 #
#                                                                 #
#                                                                 #
#                                                                 #
#             S                            E                      #
#                                                                 #
#                                                                 #
#                                                                 #
#                                                                 #
#                                                                 #
#                                                                 #
#                                                                 #
#                                                                 #
#                                                                 #
#                                                                 #
#                                                                 #
###################################################################
